fE/fE/fE/fE/fE/fE/fE/fE/fE/0h/fE/fE/fE/fE/0h/fE/fE/fE/fE/fE/fE/fE/fE/fE/
fK/4K/4K/4K/6K/fE/fE/0h/0h/0h/fB/4B/4B/6B/0h/0h/0h/fE/fC/4C/4C/4C/4C/6C/
1K/0K/0K/0K/0K/6K/0h/0h/5B/4B/0B/0B/0B/0B/4B/6B/0h/0h/1C/0C/0C/0C/0C/2C/
1K/0K/0K/0K/0K/2K/0h/0h/1B/0B/0B/0B/0B/0B/0B/2B/0h/0h/1C/0C/0C/0C/0C/aC/
9K/0K/0K/0K/0K/2K/0h/0h/0B/0B/0B/0B/0B/0B/0B/0B/0h/0h/0h/9C/8C/8C/aC/fE/
fE/9K/8K/8K/0K/aK/0h/0h/1B/0B/0B/0B/0B/0B/0B/2B/0h/0h/0h/0h/0h/0h/0h/0h/
0h/0h/0h/0h/0h/0h/0h/0h/9B/8B/8B/8B/8B/8B/0B/aB/0h/0h/0h/0h/0h/0h/0h/fE/
fE/0h/0h/0h/0h/0h/0h/0h/0h/0h/0h/0h/0h/0h/0h/0h/0h/0h/fb/4b/4b/4b/4b/6b/
fD/4D/4D/4D/6D/0h/0h/0h/0h/0h/0h/0h/0h/0h/0h/0h/0h/0h/0b/0b/0b/0b/0b/2b/
1D/0D/0D/0D/0D/4D/4D/6D/0h/0h/f0/f0/f0/f0/f0/0h/0h/0h/1b/0b/0b/0b/0b/2b/
1D/0D/0D/0D/0D/0D/0D/2D/0h/0h/f0/f0/f0/f0/f0/0h/0h/0h/1b/0b/0b/0b/0b/2b/
1D/0D/0D/0D/0D/0D/0D/0D/0h/0h/f0/f0/f0/f0/f0/0h/0h/0h/9b/8b/8b/8b/0b/ab/
1D/0D/0D/0D/0D/0D/0D/2D/0h/0h/f0/f0/f0/f0/f0/0h/0h/0h/0h/0h/0h/0h/0h/fE/
1D/0D/0D/0D/0D/0D/0D/2D/0h/0h/f0/f0/f0/f0/f0/0h/0h/0h/fL/4L/0L/4L/6L/fE/
9D/8D/8D/8D/8D/8D/0D/aD/0h/0h/f0/f0/f0/f0/f0/0h/0h/5L/0L/0L/0L/0L/0L/6L/
fE/0h/0h/0h/0h/0h/0h/0h/0h/0h/f0/f0/f0/f0/f0/0h/0h/0L/0L/0L/0L/0L/0L/2L/
0h/0h/0h/0h/0h/0h/0h/0h/0h/0h/0h/0h/0h/0h/0h/0h/0h/9L/0L/0L/0L/0L/0L/aL/
fE/0h/0h/0h/0h/0h/0h/0h/0h/fH/4H/0H/0H/4H/6H/0h/0h/0h/9L/8L/8L/8L/aL/fE/
fl/4l/4l/4l/4l/4l/2l/0h/0h/1H/0H/0H/0H/0H/2H/0h/0h/0h/0h/0h/0h/0h/0h/0h/
1l/0l/0l/0l/0l/0l/2l/0h/0h/1H/0H/0H/0H/0H/0H/0h/0h/0h/0h/0h/0h/0h/0h/fE/
1l/0l/0l/0l/0l/0l/2l/0h/0h/1H/0H/0H/0H/0H/2H/0h/0h/1S/4S/4S/4S/4S/4S/6S/
1l/0l/0l/0l/0l/0l/2l/0h/0h/1H/0H/0H/0H/0H/2H/0h/0h/1S/0S/0S/0S/0S/0S/2S/
1l/0l/0l/0l/0l/0l/al/0h/0h/1H/0H/0H/0H/0H/2H/0h/0h/1S/0S/0S/0S/0S/0S/2S/
9l/8l/8l/8l/8l/al/fE/0h/fE/9H/8H/8H/8H/8H/aH/fE/0h/fS/8S/8S/8S/8S/8S/aS/
+w,9,0|g,14,0|c,23,5|p,23,18|s,7,23|m,0,16